B_____________________________________E





HHHbeHHbeHHHbeHHbeHHHBEHHBEHHHBEHHBEHHH
HHH  HH  HHH  HH  HHH  HH  HHH  HH  HHH
HHH  HH  HHH  HH  HHH  HH  HHH  HH  HHH
HHHbeHHbeHHHBEHHBEHHH  HH  HHH  HH  HHH
HHH  HH  HHH  HH  HHH  HH  HHH  HH  HHH
HHH  HH  HHH  HH  HHH  HH  HHH  HH  HHH
HHHBEHHBEHHH  HH  HHHBEHHBEHHHbeHHbeHHH
HHH  HH  HHH  HH  HHH  HH  HHH  HH  HHH
HHH  HH  HHH  HH  HHH  HH  HHH  HH  HHH
HHH  HH  HHHbeHHbeHHH  HH  HHHbeHHbeHHH
HHH  HH  HHH  HH  HHH  HH  HHH  HH  HHH
HHH  HH  HHH  HH  HHH  HH  HHH  HH  HHH
B____________EHHBEHHHbeHHb____________e
              HH  HHH  HH     S_______Q
              HH  HHH  HH              
              HH  HHHBEHHB___E         
S_______Q     HH  HHH  HH              
              HH  HHH  HH     S_______Q
         B___EHHBEHHH  HH              
              HH  HHH  HH              
S_______Q     HH  HHH  HH              
              HH  HHHbeHHb___eS_______Q
              HH  HHH  HH              
              HH  HHH  HH              
         B_______EHHHB_______E         
                  HHH                  
   C____A         HHH         C____A   
                  HHH                  
         S_______QHHHS_______Q         
                  HXH                  
                  B_E                  
                                       
                                       
                                       
                                       
            C____A   C____A            