S_____________________________________Q





HHHB____EHHHBEHHBEHHHB____EHHHB____EHHH
HHH      HHH  HH  HHH      HHH      HHH
HHH      HHH  HH  HHH      HHH      HHH
HHH      HHHSQHHSQHHH      HHH      HHH
HHH      HHH  HH  HHH      HHH      HHH
HHH      HHH  HH  HHH      HHH      HHH
B___EHHBEHHH  HH  HHHBEHHBEHHHB____EHHH
     HH  HHH  HH  HHH  HH  HHH      HHH
     HH  HHH  HH  HHH  HH  HHH      HHH
     HH  HHHB____EHHHSQHHSQHHH      HHH
     HH  HHH      HHH  HH  HHH      HHH
     HH  HHH      HHH  HH  HHH      HHH
HHHBEHHBEHHH      HHH  HH  HHHBEHHB___E
HHH  HH  HHH      HHH  HH  HHH  HH     
HHH  HH  HHH      HHH  HH  HHH  HH     
HHHSQHHSQHHHB____EHHHB____EHHH  HH     
HHH  HH  HHH      HHH      HHH  HH     
HHH  HH  HHH      HHH      HHH  HH     
HHH  HH  HHH      HHH      HHHBEHHBEHHH
HHH  HH  HHH      HHH      HHH  HH  HHH
HHH  HH  HHH      HHH      HHH  HH  HHH
HHHB____EHHHB____EHHHB____EHHHSQHHSQHHH
HHH      HHH      HHH      HHH  HH  HHH
HHH      HHH      HHH      HHH  HH  HHH
HHH      HHH      HHH      HHH  HH  HHH
HHH      HHH      HHH      HHH  HH  HHH
HHH      HHH      HXH      HHH  HH  HHH
B_____________________________________E







   C____A   C____A   C____A   C____A   