B_____________________________________E





HHHBEHHBEHHHBEHHBEHHHBEHHBEHHHBEHHBEHHH
HHH  HH  HHH  HH  HHH  HH  HHH  HH  HHH
HHH  HH  HHH  HH  HHH  HH  HHH  HH  HHH
HHHBEHHBEHHHBEHHBEHHH  HH  HHH  HH  HHH
HHH  HH  HHH  HH  HHH  HH  HHH  HH  HHH
HHH  HH  HHH  HH  HHH  HH  HHH  HH  HHH
HHHBEHHBEHHH  HH  HHHBEHHBEHHHBEHHBEHHH
HHH  HH  HHH  HH  HHH  HH  HHH  HH  HHH
HHH  HH  HHH  HH  HHH  HH  HHH  HH  HHH
HHH  HH  HHHBEHHBEHHH  HH  HHHBEHHBEHHH
HHH  HH  HHH  HH  HHH  HH  HHH  HH  HHH
HHH  HH  HHH  HH  HHH  HH  HHH  HH  HHH
B____________EHHBEHHHBEHHB____________E
              HH  HHH  HH              
              HH  HHH  HH              
              HH  HHHBEHHB___E         
              HH  HHH  HH              
              HH  HHH  HH              
         B___EHHBEHHH  HH              
              HH  HHH  HH              
              HH  HHH  HH              
              HH  HHHBEHHB___E         
              HH  HHH  HH              
              HH  HHH  HH              
         B_______EHHHB_______E         
                  HHH                  
   C____A         HHH         C____A   
                  HHH                  
                  HHH                  
                  HHH                  
                  B_E                  
                                       
                                       
                                       
                                       
            C____A   C____A            